16 16
################
#             ##
################
#2##############
#              #
#              #
#              #
#              #
#              #
#              #
#              #
#              #
############## #
# ############ #
###         1# #
################
14 12
3 1
========= 
Gora: 0
Dol: 0
Prawo: 0
Lewo: 11
