16 15
################
#       ########
#       ########
#       #####  #
#   1     #### #
#   ###### # # #
#      ####2## #
#     ######## #
#    ####### ###
#   ########  ##
#  ########  ###
#  # ######  ###
# ##          ##
###           ##
################
4 4
6 11
========= 
