15 15
###############
##            #
###           #
##  #         #
##    #       #
######        #
#    # #      #
#    #2########
#    # #     ##
#    #1      ##
#       #    ##
#         #  ##
#           ###
#            ##
###############
9 6
7 6
========= 
Gora: 8
Dol: 4
Prawo: 6
Lewo: 0
